F  184,113,39
C  51,198,227



R 5000 5000
NO              /Users/mac/Desktop/ksuha/textures/1.png

SO           /Users/mac/Desktop/ksuha/textures/1489.png
WE     /Users/mac/Desktop/ksuha/textures/1490.png
EA /Users/mac/Desktop/ksuha/textures/1488.png

S       /Users/mac/Desktop/ksuha/textures/barrel.png










1111111111111111111111111
1000000000110000000000001
1011000001110000002000001
100100000000000000000000111111111
111111111011000001110000000000001
100000000011000001110111111111111
11110111111111000000000010001
11110111111111011101010010001
11000000110101011100000010001
10002000000000001100000010001
10000000000000000001010000001
11000001110101011111011110N0111
11110111 1110101 101111010001
11111111 1111111 111111111111